#####################
#S#.......#.........#
#.#.#####.#######.#.#
#...#...#...#...#.#.#
#####.#.###.#.#.###.#
#.....#.#...#.#.....#
#.#####.#.###.#####.#
#.....#.#.....#...#.#
#.###.#########.#.#.#
#.#...#.....#...#...#
#.#.#.#.#.###.#######
#.#.#.#.#...#.#.....#
#.#.###.###.#.###.###
#.#.#...#...#...#...#
#.#.#.###.#####.###.#
#.#...#...#...#.#...#
#.#####.###.#.#.#.#.#
#...#.#.....#.#.#.#.#
###.#.#######.#.#.#.#
#...........#.....#E#
#####################
