#####
#S#.#
#.#.#
#..E#
#####
