###############################
#S......#.....#.........#.....#
#######.#.###.###.#####.###.#.#
#.....#...#.#...#.#...#...#.#.#
#.###.#####.###.#.#.#.###.###.#
#.#.#.........#...#.#.#.#...#.#
#.#.###.#####.#####.#.#.###.#.#
#.#...#.....#.#.....#...#...#.#
#.#.#.#####.#.#.#######.#.###.#
#.#.#.#.....#...#.....#.#.#...#
#.#.#.#.#########.###.#.#.#.#.#
#.#.#.#.....#.....#...#.#.#.#.#
#.#.#.#####.#.#####.###.#.#.#.#
#...#.#...#...#.....#.#.#...#.#
#####.#.#.#####.#####.#.#####.#
#...#...#...#.#...#.........#.#
#.#########.#.###.###########.#
#.......#.#.#...#.............#
#.###.#.#.#.#.#.###############
#.#.#.#...#.#.#.............#.#
#.#.#.#####.#.###.#########.#.#
#...#.#.....#.#.#.........#.#.#
###.#.#.#####.#.#########.#.#.#
#...#...#...#.#.......#.#.#.#.#
#.#########.#.#####.#.#.#.#.#.#
#.#.......#.........#.#.#.#...#
#.###.###.#.#########.#.#.#####
#.....#.#.#...#...#...#.#.....#
#######.#.#.###.#.###.#.#####.#
#...#.....#.#...#...#.......#.#
###.#.#######.#####.###.#####.#
#...#.#.......#...#.#...#.....#
#.#.#.#####.#####.#.#####.###.#
#.#.#.#.....#.....#...#...#.#.#
#.#.#.#.#####.#.#####.#.###.#.#
#.#.#...#.....#.#.....#...#.#.#
#.#######.#.###.#.#######.#.#.#
#.#.......#...#.#...#.....#...#
#.#.#########.#####.#.#####.###
#...........#.........#......E#
###############################
