#########################################
#S..#...#.........#.......#.....#.......#
###.###.#.#.#####.###.###.#.###.#.#####.#
#.#...#...#...#.#.#...#.#.#.#.#...#.....#
#.###.#######.#.#.#.###.#.#.#.#####.###.#
#.#...#.....#.#.....#.....#.......#.#.#.#
#.#.###.###.#.#########.#########.#.#.#.#
#.#.#...#...#.........#.........#.#.#.#.#
#.#.#.###.###########.#########.###.#.#.#
#.#...#.#.............#.......#...#.#...#
#.#####.#################.###.###.#.#####
#.........................#.#.#...#.....#
#.#######.#################.#.#.#####.#.#
#...#.....#...............#.#.#.#...#.#.#
#####.###.#.#############.#.#.#.#.#.###.#
#.....#...#.#...........#.#...#...#.....#
#.#####.###.#########.#.#.#############.#
#.#.......#.....#...#.#.#.#...#...#...#.#
#.#############.#.#.#.#.#.#.#.#.#.#.#.#.#
#.................#...#.#...#...#...#..E#
#########################################
